########################
#    #    #    #   #   #
#    #  G #    #   #   #
#    #    #  @ #   #   #
#    #    #    #   #   #
2                      1
#    #    #    #   #   #
#    #    #    #   #   #
#    #    #    #  G#   #
########################