############3############
#G                      #
#G                      #
#                       #
#                       #
#                       #
#           @           #
############1############
