########################
#    #    #    #   #   #
#    #    #    #   #   #
#    #    #    #   #   #
#    #    #    #   #   #
2@                     1
#    #    #    #   #   #
#    #    #    #   #   #
#    #    #    #  G#   #
########################
